###################################################################################################
# #           #         #   #           #         #           #       #   #         #     #   #   #
# # # ####### # ####### # # # ####### ### ### ### ##### ##### # ### # # # ### ##### # ### # # # # #
# # # #     # #       # # # #     # #     #   # #     # #     # #   # # # #   #     #   #   # # # #
# ### # ### # # ####### # # ##### # ####### ### ##### # ### ##### ### # # # ####### ### ##### ### #
#   #   #   # # #       # #     # #       #   #       #   # #   #   #   # # #     #     #   #     #
### # ### ### # # ##### # ### ### ##### # ### # ######### # # # # # ##### # # ### ####### # ##### #
# # # #   #   # # #     # # #   # #     # #   #           #   # # # #   # #     # # #     #       #
# # ### ####### # # ##### # ### # # ### ### # ################# # # # # # ####### # # #############
# #   #     #   # #     # #   # # # # # #   # #             #   # # # #   #       #     #     #   #
# ### ##### # ### ### ### # ### # # # # # ### # ########### ### ### ### ### ############# ### # # #
#   #     # # #   #   #   #   #   # #   # #   # #   #     #   #   #   # #   #               #   # #
# ####### # # # ####### ### # ##### # ### ##### # # # # ##### ### ### # # ### ############# ##### #
#     #   #   #       #   # #   #   #   #     # # #   # #     # #   # # # #         #     #   #   #
### # # ### ######### ### ### # # ##### ##### # # # ##### ##### ### # # # # ######### ### ### # # #
#   # # # #         #   #   # #   #         #   # # #   #     #   # # # # #   #       #   #   # # #
# # ### # ##### ##### ##### # ############# ##### # # # ##### # ### # # # ### # ####### ####### # #
# # #   #       #     #   # #   #     #   #       # # #       #   #   #   #   # #   #   #   #   # #
# # # ##### ##### ### # # # # # # ### # # ######### # ##### ##### ####### # ### ### # ### # # ### #
# # #     # #   # #   # # # # #     #   # #     #   #     # #   #       # # # #   #   #   # # #   #
# ####### # ### # ##### # # ############# # ### # ####### ### # # ##### # # # ### # ### ### # # ###
#   #   # #     # #     # #             # # #   #   #   #     # #     # # # #   # #     #   # # # #
# # # # # ##### # # ##### ############# # # # ##### # ######### ### # # # # # ### ######### # # # #
# #   #   #   # # # #     # #   #     # # # # #     #         #   # # # # # #   #         #   #   #
# ######### # ### # # ### # # # # # ### # ### # ########### # ### # # ### # # # ######### ####### #
#         # #   #   #   # #   # # #     #   # # #         # #   # # #     # # #     #   #   #   # #
######### # ###A# ##### # ### # # ######### # # ##### ### ##### # # ####### # ### # # # ### ### # #
#       #   # # # #   # #   # # #   #       # #       # # #     # # #       # #   # # #   # #   # #
####### ##### # # # # # ### ### ### # # ##### ### ##### # # # ###o# # ####### # ### # ### # # ### #
#           #   #   # # # # #     #   # #   #     #   #     # #   # #   #   # #   # # #   # # #   #
# ########### ##### ### # # # ### ### ### # ####### # ######### ####### # # ##### # # ### # # # ###
#   #       #     # #   #     #     # #   # #       #     #     #     #   #       # #   #   #     #
# # # ##### ##### # # ### ########### # ### # # ######### # ### # ### ############# ### ######### #
# #   #       #   # # # # #           #   #   # #   #   # #   # #   # #     #   #   #   #     #   #
####### ##### # ### # # # # ############# ####### # # ### # # # ### # # # ### # # ### ### ### # ###
#   #   # #   # #   # #   # #           #         # # #   # # # #   #   #   # #   #   #   #   #   #
# # # ### # ### ##### ##### ### ##### ############# # # ##### # # ##### ### # ##### ### ### #######
# #   #       #     #     # #   #     #         #   #   #     # # #   #   #   #     #   # # #     #
# ##### ########### # ### # # ####### # ### ### # ### ### ####### # # # ####### ### # ### # # ### #
#   # # # #     #   #   # # #       # # #   # # # # # #           # # # #     # #   # #   # #   # #
### # # # # ### # ####### # # ##### # # # ### # # # # ############# # ### ### # ### # # # # ### # #
#   #   # # # #   #   #   # #     # # # # #   # # #         #       #   # #   #   # # # # # #   # #
# ##### # # # ##### # # ### # ##### ### # # # # # ######### # ######### # # ##### # # # ### # ### #
# #   #   # #       #   #   # #   # #   # # # # #   #     #   #     #   # #       # #   #   #   # #
# # # ##### # ######### # ### # # # # ### # ### ### ##### # ####### # ### ######### ### # ##### # #
#   # #     # #         # #   # #   # #   #   # #   #     # #     # #     #           # #       # #
##### # ##### ########### ### # ##### # ### # # # ### ##### # ### # ### ############# # ######### #
#     #     # #         #   # #       # #   #   # #         #   # #     #     #   #   #   #     # #
# ######### # # ####### ### # ######### # ####### ##### ####### # ####### ### # # ####### ### # # #
#         # #         #     # #         # #     #     #     # # # #         #   #           # # # #
# ####### # ######### ####### # ######### ### ####### ##### # # # # ########### ########### ### # #
#       # #   #     # #     # # #           #     # #   #     # # #   #   #   #       #   #     # #
######### ### ### # # # ### # # # ######### # # # # ### ####### # ### # # # # # ####### # ####### #
#     #     #   # #     #   # # #   #     # # # #     #         #     # #   # # #       #       # #
# ### # ### ### ### ####### ### ##### ### # ### ################# ##### ##### # # ############# # #
# #     #   # #   # #     # #   #   # #   #     #               #   #   #     # # # #           # #
# ####### ### ### ### ### # # ### # # # ######### ############# ##### ### ##### # # # ########### #
#     #     #   # #   # # #   #   #   #       #   #           #       # # #   # # # # #       #   #
# ### ##### # # # # ### # ### # ############# # ### ######### ######### # # # ### # # ##### # # # #
# #   #   #   # #   #   #   # # #               #   #         #         #   #     # # #     # # # #
# # ### # ##### ##### # ### ### ### ############### ######### ######### ########### # # ### ### # #
# #     # #   #   #   # # #   #   # #       #       #       #             #       #   # #   #   # #
# ####### ### ### ### # # ### ### ### ##### # ####### ##### ############# ##### # # ### ##### ### #
#       #   #   #     # #   #   #     # #   #         #   #   #         #     # # # # #       #   #
####### ### ### ####### # # ### ##### # # ####### ##### ##### ####### ####### # # # # # ####### # #
#     #   #   #       #   # # #     #   #   #   #     # #   #       #     #   # # # #   #     # # #
# ### ### ### # ##### ##### # ##### ##### # # # ##### # # # ####### # ### # ##### # ### ##### # # #
#   # # #   # # # #   #     #     # #   # # # #     #   # # #       # #   # #     #   # #   # # # #
# # # # ### # # # # ### ####### ### # # ### # ##### ##### # # ####### # ### # ####### # # # # # # #
# # #     # # #   #   # #     #   #   # #   #   # # #     # #   #   # #   # #     #   # # #   # # #
# # # ##### # ### ### # # ### ### ##### # ##### # # # ##### # # # # # ### # ##### # ### # ### # # #
# # # #     # #   #   #   # #       #   #         # # #   # # # # #     # #     # # # # # #   # # #
# # # # ##### ##### ####### ####### # ####### ##### # ### # ### # ####### ##### # # # # # ### # ###
# # # #   # #     #           # #   #       # #     #   #       # # #         #   # #   #   # #   #
# # ##### # ##### ### ### ### # # ######### # # ##### # ######### # # ##### ##### # ### ### ##### #
# #     #   #   #   # #   #     # # #     # # #   #   #     #       # #   # #     #   #     #     #
# ### ##### ### ### ### ### ##### # # # ### ##### # ####### ######### # # ### ####### ##### # ### #
# #   #     #   #   #   #   #   # # # # #   #     #     # # #   #   #   #     #     #   #   #   # #
# # ### ##### # # ### ####### # # # # # # ### ######### # # # # # # ### ####### ### ### # ##### # #
# #   #     # # #   #         #   #   # #   #       #   # # # #   #   #       # # #   # # # #   # #
# ### ##### # ##### # ####### ##### ### ### # ##### ### # # # ####### ##### ### # ### # # # # ### #
# # #         #     #   #   #   #     #   # #     #   # # # # #     #   # # #   # #   # #   #   # #
# # ########### ### ##### # ### ######### # ### ##### # # # # # ### ### # # # ### # ### ##### # ###
#       #       #   #     # #           # # #   #   # #   #   #   #   # #   #   # #   #     # #   #
######### ####### ### ##### ########### # # ##### # # ### ##### # ### # # ##### # ### ##### # ### #
#     #   # #   #   # #   #   #   #       #       #   # #   #   # # # # #   # #     # #     #   # #
# ### # ### # # ### # # ##### # # ##### ############### ### # ### # # # ### # ##### # # ######### #
# #     # #   #     # #     #   #     # #     #             # #   #   #   #     #   #   #       # #
# ####### # ####### # ### # ######### ### # # # ############### ### ##### # ##### ####### ### # # #
#     #     #     # #   # # #       #     # # #   #           # #       # # #     #     # # # #   #
# ### # ##### ### # ### ### # ##### ####### ##### ##### ##### # ####### # # # ##### # ### # # ### #
# # # #     #   # #   #   #   #     #     # #   #       # #   #     #   # # #     # # #     #   # #
# # # # ####### # ####### ##### ### # ### # # # ######### # ####### # ### # ##### # # # ####### # #
# # # # #     # # #     #     #   # # #   # # #           #         #   # #   #   # #     #     # #
# # # ### # ### # # ### ##### ### # # # ### # # # ##################### # ##### ########### ##### #
#   #     #     #   #       # #   # # #   # # # # #     #   #   #     # # #     #       #   #     #
### ################# ####### # ### # ### # # # ### ### # # # # # # ### # # ####### ### # ### #####
#                   #           #     #   #   #       #   #   #   #     #           #     #       #
###################################################################################################
