###################################################################################################
# #     #           #           #   #   #           #           #       #     #   #         # #  A#
# # ### ### ####### # # ####### ### # # # ####### ### # ######### ##### # # ### # # ##### # # # # #
# #   # #   # #       # #     #   #   #     #   #   # # #         #   #   #     # #   #   # #   # #
# ### # # ### # ######### ### ### ######### # # ### # # # ######### # ########### ### # ### ##### #
# #   #   #       #         #   #         #   #   # # #   #     #   # #         #   # #   # #     #
# # ############### ########### ######### ######### # ##### # # # ### # ####### ### # ### # # #####
# # #   #   #       #           #       # #       # # # #   # #   #     #   #     #   #   # #     #
# # # # # # # ####### # ######### ####### # ##### # # # # ### ####### ### # ##### ##### ### ##### #
# # # # # #   #       # #     #         #   #   # #   #   #   #     # #   #     # #   # # #     # #
# # # # # ##### ######### ### # ####### ####### # ### # ### ### ### ### ####### ### # # # ##### # #
# #   #   #   #           # # #   #             #   # #   #     # #   # # #   #     #   #       # #
# ####### # ##### ####### # # ### # ############### # ### ####### ### # # # # ##### ######### ### #
#   #   #   #   # #     #   #   # # #     #       # # #     #     #   # #   # #     #       #     #
### # # # ### # # # ### # ##### ### # ### # ##### # # ##### ### # # # # ##### # ##### ##### ##### #
# #   # # #   # # # #   # #   #   #   # # #     #   # #   #     # # # #     #   #   #     # #   # #
# ##### ### ### # # # ##### # ### # ### # ##### ##### # # ####### # # ##### # ### # ### ### # ### #
# #     #   # # # # #   #   #   # #     #     # # #   # #   #     # #   #   #   # #     #   #     #
# # ##### ### # ### ### # ##### # ##### ##### # # # ### ### ### ### # ### # ##### ####### ### #####
# #     #   #   #   #   # # #   #     #     #   #       # #   # #   # #   # #     # #     #   #   #
# ##### ### # ### ### ### # # ### ### ##### ############# ### ### ### # ##### ##### # ##### ### # #
#   # #     #     # #     # #   #   # #   # #         #     #   # # # # #   # #     # #     #   # #
# # # ############# ####### ### ##### ### # ### ##### # ### ### # # # # # # # ##### # ####### ### #
# #   #     #           #     # #     #   #     #   # #   #   # # #   #   #         #           # #
# ### ### ### # ##### ### # # # # ##### ######### ### ### ##### # ################# ############# #
# # #     #   #   #   #   # # # # #           #     #   #     # # #           #     #     #     # #
# # ##### # ##### ##### ### # # # # ##### ##### ### ### # ### # # # ######### ####### ### # ### # #
# #       # #   #     #   # # #   #     #     # # #   # # # #     #   #     #   #   # # #   # #   #
# ######### # # ##### ### # # ######### ##### # # ### # # # ######### # ### ### # # # # ##### ### #
#   #       # #   # #     # # #           #   #   # # # # #     #     # #     # # #   #   # #     #
### # ####### ### # ####### ### ######### # ##### # # # # ### # # ####### ##### # ##### # # # #####
#   #   # #   #   #       #     #   #   # # #     # # # #     # # #     # #     #   #   # # #     #
# ##### # # # # ####### ######### # # # # # # ##### # # ####### # # ### # # ####### ### # # ##### #
# #     #   # # #     #           # # # # # #       #   # #     # #   #   # #       #   #   # #   #
# # ######### # # ### # # ######### # # ### ####### ##### # ##### # # ##### # # ##### ##### # # ###
# # #         # # #   # # #     #   # #   #   #   #   #     #     # #       # # # #   #       #   #
# # # ######### # # ### # # # ### ### ### # # ### ### # ##### ##### ########### # # # # ######### #
# # # #       #   # #   # # #     #   # #   # #     # #     #   # # #           #   # # #       # #
# # # ##### # ##### # ### ####### # ### ##### # # ### ######### # # ####### # ####### ### ### ### #
# #   #   # #       # #   #     # #   #     # # # #   #       # #   #     # #   #     #   #   #   #
# ### # # ####### ##### # # ### ##### # ##### # ### ### ##### # # ### ### # ### # ##### ### ### ###
#   # # #   #   #       # # # #   #   # #     #   #     #   #   # #   #   #   # # #     # # #   # #
### # # ### # # ########### # ### # ### # ####### ######### ##### # ### ##### # # # ##### # # ### #
#   # #   #   # #     #     # #  o# #   # #   #         #   #   #   # #   #   # # # #     # # #   #
# ### ### ##### # ### # ##### # ### # # # # # # ####### # # # # ##### ### ##### # # ### ### # ### #
# #   # # #   # # # # #     #     # # # #   #   #   #     #   #         # #   # #     # #   # #   #
# # ### # ### # # # # ##### ##### # # # ######### ### ######### ######### # # # ##### # # # # # ###
# #     #   # # # # #     #   # #   # #   #     #   # #   #     #         # # #   # # # # # # #   #
# # ##### # # # # # ##### # # # ##### ##### # ### # # # # ####### ######### # # # # # # # ### # # #
#   #   # # #     #       # # #       #     #   # # # # #   #     #         # # # #   # # #   # # #
##### # ### ####### ####### # ##### ### ####### # # # # ### # ##### # ####### # # # ### # # ##### #
#     #     #   #   # #     #     # #   #     #   #   #   #   #     # #     # # # #     # # #     #
# ####### ### # # ### # ######### # # ### ### ########### ########### # # # # ### ##### # # # ### #
# #       #   # # #     #       # # # #   #   #         # #           # # # #     # #   # # # #   #
# ####### # ### # ####### ##### # # # # ####### ####### # # ### ####### # ######### # ### # # # ###
#       # # #   #         # #   # # # #   #   #   #   #   # # # # #     #         #   # #     #   #
# ##### # # # ############# # ### # # ### # # ### # # ##### # # # # ######### ### # ### ###########
# # #   # # #     #     #     #   # #   # # #   # # #     #   # # #   #     #   #   #   #         #
# # # # ### ##### # ### # ##### # # ### # # # ### # ##### ##### # # ### ### ##### ### # # ####### #
# # # # #   #   # # # # #     # # # #   # # #     #   #       # #   #   # #     #   # # # #     # #
# # # ### ### # # # # # ##### ### # # ### # ####### # ####### # ##### ### ##### ### # # # # # ### #
# # #     #   #   # # #       #   # # #   #   #     #     #     #     #       # #     # # # #   # #
# # ####### ####### # ######### ### # # ##### ####### ### # ##### ####### ### # ####### # ##### # #
#       #   #     # #     # #     # # #     # #     #   # #   #   #       #   #   #   # #   #   # #
####### # ####### # ### # # # ### # # # # ### # ### ##### ### # ### ####### ##### # # # ### # ### #
#     # #       # #     # #     # #   # # #   #   #       #   #     #   #   #   # # #   #   #   # #
# # ### ####### # ####### ##### # # ##### # ### # ################### # # ### ### ####### ##### # #
# # #       #   #       #   # # # #       # #   #   #       #     #   #     #   # #       #     # #
# # # ####### ### ### ##### # # # ######### # ##### # ##### # ### # ####### ### # # ####### # ### #
# # # #     #   # # #       #   # #   #     # #   #       #   # #     #   #     #   #       #   # #
# # # # ### ### # # ############# # # # ####### # ####### ##### ##### # # ##### ##### ######### # #
# #   #   #     #     #           # # # #     # #     # # #     #   # # #     #     # #         # #
# ####### ########### # # ####### # # # ### # # ##### # # ### # # # ### ##### ##### ### ######### #
#   #   #   #       # # # #     # # # #     #   #   # #   #   # # #   #   #     #       #       # #
### # # ### # ##### # # ### ### ### # ############# # # ### ### # ### # # ##### ######### ##### # #
#   # #   #   #   # #   #   # # #   #               # #     #   #   # # #     #     #     #   # # #
# ##### # ##### # # ### # ### # # ### ############# # ####### ##### # ##### # ##### # ##### # # # #
#   #   #   #   # # #   #     # # # #             # # #   #       # # #   # # #       #     # # # #
### # ##### ##### # ##### ##### # # ############# # # # # ##### ### # # # ### # ####### ##### # # #
# #   #   # #     #   #   #     # #       #     # # # # # #   # #   # # #     # #   #   #     #   #
# ##### # # # ### ### # ### ##### ##### # ### ### # # # # # # ### ### # ### ##### # # # ##### ### #
#       #     # # # #     #   #   #   # #     #   # #   #   # #   #   #   # #     # # #     # #   #
# ############# # # ######### # ### # # ##### # ### ######### # ### ### # ### ##### # ##### ### ###
#   #         #     #   #     # #   # #   #   # #   #   #     # #   # # # #   # #   # #     #   # #
### # ####### ####### # # ### # # # # ### ### # # ##### # ##### # ### # # # ### # ### # ##### ### #
# # # #   #   #   #   #   #   # # # #   #   # # # #     # #   # # #     #     # # #   #       #   #
# # # # ### ### # # ####### ### ### ### ### ### # ### # # # # # # ########### # # ##### ####### ###
#   # # #   #   #   # #       #     # #   #   # #   # # #   #   #     #     #   #     # #     #   #
# ### # # ### ####### # ############# ### ### # ### # ############### # ### ### ##### # ### # ### #
# #   # # #   #   #     #         #     #   # # #     #           # #   # #   #   #   # #   #     #
### ### # ### # ### ##### ####### # ### ### # # ####### # ####### # ##### ### ##### ### # ####### #
#   #   # #   #     #     #       # # #     # # #   #   #   # #       #       #     # # #     # # #
# ### ### # ### ##### ##### ####### # ####### # # # # ##### # # ####### ####### ##### # ##### # # #
# #         #   #     #   #     #   #         #   #   #   # # # #     # #       #     #       # # #
# ############### ####### ##### # ##### ##### ######### ### # # # ### # ### ##### # # ######### # #
# #     #         #           # # #   # # #   #         #   #   #   #   #   # #   # #   #       # #
# # ### # ######### ######### # # # # # # # ####### ### # ######### ##### ### # ### ##### ### ### #
#     #             #         #     #   #           #   #                 #       #         #     #
###################################################################################################
