####################################################################################################
#         #         #         #         #         #         #         #         #         #        #
#         #         #         #         #         #         #         #         #         #        #
#         #         #         #         #         #         #         #         #         #        #
#         #         #         #         #         #         #         #         #         #        #
#         #         #         #         #         #         #         #         #         #        #
#         #         #         #         #         #         #         #         #         #        #
#         #         #         #         #         #         #         #         #         #        #
#         #         #         #         #         #         #         #         #         #        #
#         #         #         #         #         #         #         #         #         #        #
#         #         #         #         #         #         #         #         #         #        #
#         #         #         #         #         #         #         #         #         #        #
#         #         #         #         #         #         #         #         #         #        #
#         #         #         #         #         #         #         #         #         #        #
#         #         #         #         #         #         #         #         #         #        #
#         #         #         #         #         #         #         #         #         #        #
#         #         #         #         #                   #         #         #         #        #
#         #         #         #         #                   #         #         #         #        #
#                             #         #         #         #         #         #         #        #
#                             #         #         #         #         #         #         #        #
#         #         #         #         #         #         #         #         #         #        #
#         #         #         #         #         #         #         #         #         #        #
#         #         #         #         #         #         #         #         #         #        #
#         #         #         #         #         #         #         #         #         #        #
#         #         #         #         #         #         #         #         #         #        #
#         #         #         #         #         #         #         #         #         #        #
#         #         #         #         #         #         #         #         #         #        #
#         #         #         #         #         #         #         #         #         #        #
#         #         #         #         #         #         #         #         #         #        #
#         #         #         #         #         #         #         #         #         #        #
#         #         #         #         #         #         #         #         #         #        #
#         #         #         #         #         #         #         #         #         #        #
#         #         #         #         #         #         #         #         #         #        #
#         #         #         #         #         #         #         #         #         #        #
#         #         #         #         #         #         #         #         #         #        #
#         #         #         #         #         #         #         #         #         #        #
#         #         #         #         #         #         #         #         #         #        #
#         #         #         #         #         #         #         #         #         #        #
#     A   #         #         #         #         #         #         #         #         #        #
#         #         #         #         #         #         #         #         #         #        #
#         #         #         #         #         #         #         #         #         #        #
#         #         #         #         #         #         #         #         #         #        #
#         #         #         #         #         #         #         #         #         #        #
#         #         #         #         #         #         #         #                   #        #
#         #         #         #         #         #         #         #                   #        #
#         #         #         #         #         #         #         #         #         #        #
#         #         #         #         #         #         #         #         #         #        #
#         #         #         #         #         #         #         #         #         #        #
#         #         #         #         #         #         #         #         #         #        #
#         #         #         #         #         #         #         #         #         #        #
#         #         #         #         #         #         #         #         #         #        #
#         #         #         #         #         #                   #         #         #        #
#         #         #                   #         #                   #         #         #        #
#         #         #                   #         #         #         #         #         #        #
#         #         #         #         #         #         #         #         #         #        #
#         #         #         #         #         #         #         #         #         #        #
#         #         #         #         #         #         #         #         #         #        #
#         #         #         #         #         #         #         #         #         #        #
#         #         #         #         #         #         #         #         #         #        #
#         #         #         #         #         #         #         #         #         #        #
#         #         #         #         #         #         #                   #         #        #
#         #         #         #         #         #         #                   #         #        #
#         #         #         #         #         #         #         #         #         #        #
#         #         #         #         #         #         #         #         #         #        #
#         #         #         #         #         #         #         #         #         #        #
#         #         #         #         #         #         #         #         #         #        #
#         #         #         #         #         #         #         #         #         #        #
#         #         #         #         #         #         #         #         #         #        #
#         #         #         #         #         #         #         #         #         #        #
#         #         #         #         #         #         #         #         #         #        #
#         #         #         #         #         #         #         #         #         #        #
#         #         #         #         #         #         #         #         #         #        #
#         #         #         #         #         #         #         #         #         #        #
#         #         #         #         #         #         #         #         #         #        #
#         #         #         #         #         #         #         #         #         #        #
#         #         #         #         #         #         #         #         #         #        #
#         #         #         #         #         #         #         #         #         #        #
#         #         #         #         #         #         #         #         #         #        #
#         #         #         #         #         #         #         #         #         #        #
#         #         #         #         #         #         #         #         #         #        #
#         #         #         #         #         #         #         #         #         #        #
#         #         #         #         #         #         #         #         #         #        #
#         #         #         #                   #         #         #         #         #        #
#         #         #         #                   #         #         #         #         #        #
#         #         #         #         #         #         #         #         #         #        #
#         #         #         #         #         #         #         #         #         #        #
#         #         #         #         #         #         #         #         #                  #
#         #         #         #         #         #         #         #         #                  #
#         #         #         #         #         #         #         #         #         #        #
#         #         #         #         #         #         #         #         #         #        #
#         #         #         #         #         #         #         #         #         #        #
#         #         #         #         #         #         #         #         #         #        #
#         #         #         #         #         #         #         #         #         #        #
#         #         #         #         #         #         #         #         #         #        #
#         #         #         #         #         #         #         #         #         #        #
#         #         #         #         #         #         #         #         #         #        #
#         #         #         #         #         #         #         #         #         #        #
#         #         #         #         #         #         #         #         #         #        #
#         #         #         #         #         #         #         #         #         #    o   #
####################################################################################################
