####################################################################################################
#                                                 #                                                #
#                                                 #                                                #
#                                                 #                                                #
#                                                 #                                                #
#                                                 #                                                #
#                                                 #                                                #
#                                                 #                                                #
#                                                 #                                                #
#                                                 #                                                #
#                                                 #                                                #
#                                                 #                                                #
#                                                 #                                                #
#                                                 #                                                #
#                                                 #                                                #
#                                                 #                                                #
#                                                 #                                                #
#                                                 #                                                #
#                                                 #                                                #
#                                                 #                                                #
#                                                 #                                                #
#                                                 #                                                #
#                                                 #                                                #
#                                                 #                                                #
#                                                 #                                                #
#                                                 #                                                #
#                                                 #                                                #
#                                                 #                                                #
#                                                 #                                                #
#                                                 #                                                #
#                                                 #                                                #
#                                                 #                                                #
#                                                 #                                                #
#                                                 #                                                #
#                                                 #                                                #
#                                                 #                                                #
#                                                 #                                                #
#                                                                                                  #
#                                                 #                                                #
#                                                 #                                                #
#                                                 #                                                #
#                                                 #                                                #
#                                                 #                                                #
#                                                 #                                                #
#                                                 #                                                #
#                                                 #                                                #
#                                                 #                                                #
#                                                 #                                                #
#                                                 #                                                #
#                                                 #                                                #
######### ###################################################### ###################################
#                                                 #                                                #
#                                             A   #                                                #
#                                                 #            o                                   #
#                                                 #                                                #
#                                                 #                                                #
#                                                 #                                                #
#                                                 #                                                #
#                                                 #                                                #
#                                                 #                                                #
#                                                 #                                                #
#                                                 #                                                #
#                                                 #                                                #
#                                                 #                                                #
#                                                 #                                                #
#                                                 #                                                #
#                                                 #                                                #
#                                                 #                                                #
#                                                 #                                                #
#                                                 #                                                #
#                                                 #                                                #
#                                                 #                                                #
#                                                 #                                                #
#                                                 #                                                #
#                                                 #                                                #
#                                                 #                                                #
#                                                 #                                                #
#                                                                                                  #
#                                                 #                                                #
#                                                 #                                                #
#                                                 #                                                #
#                                                 #                                                #
#                                                 #                                                #
#                                                 #                                                #
#                                                 #                                                #
#                                                 #                                                #
#                                                 #                                                #
#                                                 #                                                #
#                                                 #                                                #
#                                                 #                                                #
#                                                 #                                                #
#                                                 #                                                #
#                                                 #                                                #
#                                                 #                                                #
#                                                 #                                                #
#                                                 #                                                #
#                                                 #                                                #
#                                                 #                                                #
#                                                 #                                                #
####################################################################################################
